   **************************************************
*                                                   *
*                                                   *
*     ****                                 ****     *
*        *                                 *        *
*        *    %                            *        *
*        *                                 *        *
*        *        *****************        *        *
*        *        *               *        *        *
*        *               $$$      *        *        *
*        *               $$$      *        *        *
*        *               $$$      *        *        *
*        *        *              #*        *        *
*        *        *****************        *        *
*        *                                 *        *
*        *                            %    *        *
*        *                                 *        *
*     ****                                 ****     *
*                                                   *
*                                                   *
*****************************************************